BBBBBBBGGGBBBBBB
BGGGGGGGGGGGGGGB
BGGGGGGGGGGGGGGB
BGGGGGGGGGGGGGGB
BGGGGGGGGGGGGGGB
BGGGGGGGGGGGGGGB
BGGGGGGGGGGGGGGB
GGGGGGGGGGGGGGGG
GGGGGGGGGGGGGGGG
GGGGGGGGGGGGGGGG
BGGGGGGGGGGGGGGB
BGGGGGGGGGGGGGGB
BGGGGGGGGGGGGGGB
BGGGGGGGGGGGGGGB
BGGGGGGGGGGGGGGB
BBBBBBBGGGBBBBBB
